a gay	a salad tosser
abacus	chink calculator
abbreviate	shortamake
abbreviation	shortamake
abdomen	stomik
abdominal	abdomininable
abduct	kinnap
abilities	skeelz
ability	skeel
abnormal	fukt
abominable	fukt
abort	stawp
abortion	induced termination of pregnancy before the fetus can survive
about	bout
above	ontop
abracadabra	abacadaba
abrupt	real sudden like
absent	not dere
absolut	vodka
absolute	total
abstemious	showing moderation abstemiously
abstract	whack
absurd	stoopid
abundance	lots
abuse	whack up
abused	whacked up
abyss	deep crack
academy	whitey skoo
accelerate	go fasta
accelerated	went fasta
accelerating	goin fasta
accent	lisp
accept	assept
acceptable	asseptabul
acceptance	asseptince
accessories	assessorees
accessory	partna in cryme
accident	"assident"
accomplice	partna in cryme
accordian	white mans rap
account	munny hold
accurate	rite
acquire	teef
acquired	teefed
action	deth
addict	crackhead
addicts	crackheads
address	crib numba
adjective	w0rd
adjust	break
adjusted	broked
adjusting	breaking
admit	confess
adopt	kinnap
adopted	kinnaped
adopting	kinnaping
adultery	sex wit da wife
advice	niggaspeak
advocate	lawya
afford	steal
afraid	fraid
africa	da mudda land
again	twotime
agency	gang
agent	fed
agreement	deel
aids	da sex shiet
air	wind
aircraft	flyin shiyat
aircrafts	flyin shiyats
alcohol	intoxicatin liqour
alimony	cost o luv
all	alls
alley	place o beats
almost	not quite
alphabet	letturz
alright	aite
alrite	aite
am	be
amateur	whack
ambulance	deth-mobile
ambush	gang jump
ambushed	jumped
america	land o da free shiyat
american	afro-american
amigo	homie
ammo	caps
ammunition	ammo
amory	gunshak
amoury	gunshak
an	a
and	an'
angry	pist
answer	ansa
antelope	swift running mammal
anthem	hymn
antiques	ol shiet
anti-semite	kike-hater
anton	Fatass
any	allz
anyway	anyways
appeal	last chance
appealed	tried fo da last time
appeared	popped up
approve	good stamp
approved	good stamped
are	is
arena	deth box
armies	gangs
army	uncle sam's gang
aroma	stank
arrest	nigga catch
arrested	nigga caught
arresting	nigga catchin
artificial	whack
artillery	big gats
artist	poor nigga
artwork	teefables
as	like
asexual	fag
ashtray	jointbox
asian	chink
ask	aks
asked	aksed
asleep	a target
ass	rectum
assasin	killa
assasins	killas
assault	beat
assaulted	beated
assaulting	beatin
assist	help
astronaut	spacewhitey
asylum	whack nigga hole
ate	munched
athlete	nigga
attain	git
attained	got
attorney	nigga protecta
auction	slave sale
auctioneer	slave trader
auctioning	slave trading
auctions	slave sales
audio	rap
automobile	wheels
automobiles	wheels
autopsy	body check
avenue	skreet
avenues	skreets
away	dispeared
babies	shorties
baby	shorty
babys	shorties
back	backside
backhand	smack
backpack	teefpak
bad	whack
baggage	thiefables
bail	drug money
bailiff	whitey bounca'
bailiffs	whitey bounca's
bait	lure
bake	foodamake
baking	foodamakin
balconies	nigga backyards
balcony	nigga backyard
bald	shiny cueball
ball	rock
balloon	bubble
balls	nutz
banana	monkey food
bananas	monkey food
bandage	quicker thicker fixer upper
bandages	quicker thicker fixer uppers
band-aid	bloodcap
band-aids	bloodcaps
bandit	gangsta
bandits	gangstas
bank	one stawp cryme shawp
barbarian	nigga
barbarians	niggas
barbeque	BBQ
barbeques	BBQs
barber	fro choppa
barbers	fro choppas
bare	nekkid
bareback	nekkid
barf	puke
bargain	tiefable
bargains	tiefables
baseball	whiteyball
basement	place o bidniss
bash	smack
bashed	smaked
bashing	smakin
basketball	b-ball
bastard	basturd
bat	stick
bathroom	bafroom
battle	gang fight
battled	fighted
battles	gang fights
bawd	ho
bayonet	impalin stik
beach	hunny huntin grounds
beaches	hunny huntin grounds
beard	face fro
bearded	face fro'd
beards	face fros
became	came be
because	cuz
become	come be
bee	stingin bitch
beer	firewater
beg	cry
begged	cryd
begging	cryin
belief	beeleef
believe	beeleef
believed	beeleefed
bell	dingdong
bells	dingdongs
belly	stomak
best	bestest
better	best
beverage	firewadda
beware	be fraid
bible	goo' book
big	biggy
bilingual	twotalkin
bingo	fogieball
bird	flyin meal
birds	flyin meals
birth	berf
birthday	berfday
bitch	biatch
bj	hoodsuck
black	ebony
blackout	nigga's oppatunity
blade	cuttah
blank	empty
blast	fart
blasting	fartin
blasts	fartz
bleeding	spurtin red shiyat
blind	target
blood	red shit
blowjob	hoodsuck
blue	wadda like
bluff	lie
boar	meal on wheels
bobsled	niggamobile
bodyguard	protecta
book	readz
books	readzez
boot	footcap
born	berfed
boulder	biggarock
bourbon	firewadda
bout	brawl
boutique	sto
bovine	cowalike
box	square
boxed	squared
boy	shorty
boys	shortys
brain	hed
brawl	tussle
bread	eats
breakfast	meal on wheels
breakfasts	meals on wheels
breast	titty
breasts	titties
brian	Gumbo
bribe	payoff
bribes	payoffs
bride	cashleech
briefcase	drugcase
brittle	bustable
brochure	pamflit
broken	busted
brother	brutha
brothers	bruthas
brunch	white mans eats
bullet	cap
bum	ass
business	bidniss
butt	ass
buy	steal
camera	nigga-detecta
canada	last stop on da undaground railroad
car	wheels
carefully	wit da skills
chemical	chemo shiyat
chemicals	chemo shiyatz
child	shorty
children	shorties
cocaine	crack
come	cum
commit	do
commited	did
commiting	doin
communication	talkin
communications	shoutins
component	part
components	partz
computer	geekbox
computers	geekboxes
condition	rool
conditions	roolz
condom	dick hat
confess	admit
contact	speakamake
copies	tiefs
cops	nigga huntas
copycat	idea theef
corporation	Gang
countries	cuntrees
country	cuntree
cow	moomoo
crap	shiyat
damn	daeum
david	2 inches-o-luv
death	deth
describe	esplain
described	esplaind
die	get popped
died	went 6 feet unda
dildo	fake-wang
dirty	durty
discount	5 finga dixount
documentation	readz
dog	dawg
dogs	dawgs
drugs	shit
dumb	num
eat	munch
eating	munchin
ejaculate	cum
electronic	all technical like
eli	Fag-boy
english	ingish
entitle	gib
entitled	gibd
entitles	gibs
environmental	vironmentel
environments	virenmentz
equipment	shiyat
family	bruthas an sistas
farm	grassy crib
fbi	feds
federal	fedzerel
fight	tussle
fighter	tussler
fighters	tusslers
fights	tussles
fix	break
fixed	broked
fixing	breakin
flower	plant
flowers	plants
food	eats
foods	eats
fool	foo
fools	foos
for	fo
friend	homie
friends	homies
from	frum
fuck	fawk
fucked	fukt
fucking	fukin
fucks	fawks
gamble	bet
gambler	betta
gay	fag
gays	many fags
get	git
gets	gits
give	gib
gives	gibs
go	jet
god	OJ
going	jettin
good	phat
government	elected representatives who dun gib a shiyat bout me
governments	elected representatives who dun gib a shiyat bout me
gun	gat
guns	gats
hair	afro
hairdresser	fro choppa
hairdressers	fro choppas
hairs	afros
has	gots
hate	gonna pop
have sex	fuck
head	think
hello	yo
help	mercy
hi	yo
home	crib
hottie	fox
house	crib
houses	cribs
how	hows
i	me
im	me be
important	impotent
include	wif
including	wif
indian	packie
indians	packies
install	put in
installed	putted in
installing	puttin in
internet	geekwire
is	be
its	it be
jail	big nigga crib
jails	big nigga cribs
japanese	jap
jew	kike
jews	kikes
judge	white deth
ketchup	red burga shiyat
kid	shorty
kidnap	kinnap
kids	shorties
kill	pop
killed	popped
ladies	hunnies
lady	hunny
larry	Rap masta larf
lesbian	muff muncha
lesbians	muff munchas
license	fake ID
lie	bluff
liquor	firewata
little	lil
look	peep
love	luv
lover	luvva
lovers	luvvas
loves	luvs
lying	shittin
man	brotha
marijuana	weed
market	markit
microsoft	macroshit
mom	momma
moms	mommas
money	doh
more	mo
mother	momma
mothers	mommas
multiple	many
murder	187
murdered	187d
murdering	187in
music	rap
mustard	dijon
my	mah
naked	butt nekkit
nasty	nafty
naughty	skanky
navy	uncle sam's wadda gang
nigger	nigga
niggers	niggas
nighttime	niggas playtime
no	naw
not	nawt
nuclear	nukular
number	numba
nut	left nut
nuts	balls
of	o
officer	offica
officers	officas
oh	o
oj	savior
ok	aite
okay	aite
old	ol'
online	on da geek wire
on-line	on da geek wire
operating	busting
orgasm	mind blow
over	ova
pakistani	paki
pakistanis	pakis
pamphlet	pamflit
pedophile	baby-luva
pedophiles	baby-luvas
penis	dick
penises	dicks
people	brothas
person	brotha
personal	selph
pig	bacon
pigs	bacons
plain	simple
please	 
please?	 
police	bitches in blue
poo	turd
porno	luv-bideo
pornos	luv-bideos
product	shiyat
products	shiyats
prostitute	ho
prostitutes	ho's
protest	riot
protested	rioted
protesting	riotin
provide	steal
provided	stolen
puke	barf
puked	barfd
pukes	barfs
pussies	women-holes
pussy	women-hole
radio	boombox
radios	boomboxes
ran	hit da skeet
require	need
requiring	needin
retard	reetard
retarded	stoopid
retards	reetards
sale	tiefing
sandwich	sangwich
sandwiches	sangwiches
school	hell
schooled	lurnt
schooling	lurnin
schools	skoos
screw	skroo
screws	skroos
sea	wadda
seas	watas
see	peep
shit	shiyat
shits	shiyats
shoe	footcap
shoot	cap
shot	capped
shots	caps
sing	rap
singer	rappa
singers	rappas
sister	sista
sisters	sistas
skill	skeel
skills	skeelz
sleeping	haf dead
software	warez
sorry	weepy
speak	talks
speaker	speaka
speakers	speakas
speaks	talks
ste	mah nigga Singh
stephen	mah nigga Singh
stink	stank
stinks	stanks
stomach	stomiq
store	sto
stores	stos
street	skreet
streets	skreets
stuff	loot
stuffed	stuphed
stupid	num in da head
subject	sujjekt
sun	gorby
system	systum
taxi	paki patrol
taxis	paki patrols
teach	lurn
teacher	teech
teachers	teeches
teaching	lurnin
techno	white mans rap
technology	techy shiyat
television	pictcha box
televisions	pictcha boxes
terms	w0rdz
thank	fuck
thanks	fucks
that	dat
thats	das
the	da
their	theys
theirs	theys
them	dem
there	dere
theres	dere be
these	dese
theyre	dey be
thing	ting
think	tink
thinking	tinking
this	dis
thought	tinked
tired	assed out
to	tah
tv	pictcha box
tvs	pictcha boxes
u.s.a	land o da free shiyat
u.s.a.	land o da free shiyat
ugly	nafty
under	unda
usa	land o da free shiyat
vagina	pussy
vaginas	pussys
vcr	peekbox
vcrs	stolen shit
very	bery
video	bideo
videos	bideos
vomit	barf
vomited	barfd
vomiting	barfin
vomits	barfs
water	drink
watering	washin
waters	drinks
weapon	gat
weapons	gats
went	jetted
what	wut
whatever	whateva
whats	wuts
which	wich
whore	ho
whores	ho's
why	wha
wife	bitch
will	gonna
with	wif
woman	ho
women	ho's
word	w0rd
words	w0rds
wrestle	tussle
wrestler	tussler
wrestlers	tusslers
wrestling	tusslin
yeah	ye ye ye
yelled	cried
yep	ye
yes	ye
you	yo
your	yo
you're	yer
yup	ye